S,X,X,X,X,X,X,X,X,X,X,X,X,X,X
O,X,O,O,X,O,O,O,O,O,X,O,O,O,X
0,O,O,O,O,O,O,X,X,X,X,X,X,X,X
X,X,X,X,X,X,O,X,X,X,O,O,O,X,O
X,O,O,O,O,O,O,O,O,O,O,O,X,O,O
X,X,X,X,X,O,X,X,X,X,X,X,E,X,O
O,O,O,O,O,O,O,O,O,O,O,X,O,X,O
0,X,X,X,X,X,X,X,X,X,X,X,O,X,O
O,O,O,O,O,O,O,O,O,O,O,X,O,X,O
O,X,X,X,X,X,X,X,X,X,X,X,O,O,O
O,O,O,O,O,O,O,O,O,O,O,O,O,O,O
X,X,O,X,X,X,X,X,X,X,X,X,X,X,X
O,O,O,O,O,O,O,O,O,O,O,O,O,O,O
X,O,O,O,O,O,O,X,X,X,X,X,O,O,O


